gmm|gmm|gmm|gmm|gmm|gmm|gmm|gmm|gmm|gmm|gmm|gmm|gmm|gmm|gmm|gmm|gmm|gmm|gmm|gmm|gmm|gmm|gmm|gmm|gmm|gmm|gmm|gmm|gmm|gmm|gmm|gmm|gmm|gmm|gmm|gmm|gmm|gmm|gmm|gmm|gmm|gmm|gmm|gmm|
gmm|gmm|gmm|gmm|gmm|gmm|gmm|gmm|gmm|gmm|gmm|gmm|gmm|gmm|gmm|gmm|gmm|gmm|gmm|gmm|gmm|gmm|gmm|gmm|gmm|gmm|gmm|gmm|gmm|gmm|gmm|gmm|gmm|gmm|gmm|gmm|gmm|gmm|gmm|gmm|gmm|gmm|gmm|gmm|
gmm|gmm|gmm|gmm|gmm|gmm|gmm|gmm|gmm|gmm|gmm|gmm|gmm|gmm|gmm|gmm|gmm|gmm|gmm|gmm|gmm|gmm|gmm|gmm|gmm|gmm|gmm|gmm|gmm|gmm|gmm|gmm|gmm|gmm|gmm|gmm|gmm|gmm|gmm|gmm|gmm|gmm|gmm|gmm|
gmm|gmm|gmm|gmm|gmm|gmm|gmm|gmm|gmm|gmm|gmm|gmm|gmm|gmm|gmm|gmm|gmm|gmm|gmm|gmm|gmm|gmm|gmm|gmm|gmm|gmm|gmm|gmm|gmm|gmm|gmm|gmm|gmm|gmm|gmm|gmm|gmm|gmm|gmm|gmm|gmm|gmm|gmm|gmm|
gmm|gmm|gmm|gmm|gmm|gmm|gmm|gmm|gmm|gmm|gmm|gmm|gmm|gmm|gmm|gmm|gmm|gmm|gmm|gmm|gmm|gmm|gmm|gmm|gmm|gmm|gmm|gmm|gmm|gmm|gmm|gmm|gmm|gmm|gmm|gmm|gmm|gmm|gmm|gmm|gmm|gmm|gmm|gmm|
gmm|gmm|gmm|gmm|gmm|gmm|gmm|gmm|gmm|ctl|gbm|gbm|gbm|gbm|gbm|gbm|gbm|ctr|gmm|gmm|gmm|gmm|gmm|gmm|gmm|gmm|gmm|gmm|gmm|gmm|gmm|gmm|gmm|gmm|gmm|gmm|gmm|gmm|gmm|gmm|gmm|gmm|gmm|gmm|
gmm|gmm|gmm|gmm|gmm|gmm|gmm|gmm|ctl|gbr|   |   |   |   |   |   |   |gbl|gbm|ctr|gmm|gmm|gmm|gmm|gmm|gmm|gmm|gmm|gmm|gmm|gmm|gmm|gmm|gmm|gmm|gmm|gmm|gmm|gmm|gmm|gmm|gmm|gmm|gmm|
gmm|gmm|gmm|gmm|gmm|gmm|gmm|gmm|gmr|   |   |hll|hmm|hmm|hrr|   |   |   |   |gbl|gbm|ctr|gmm|gmm|gmm|gmm|gmm|gmm|gmm|gmm|gmm|gmm|gmm|gmm|gmm|gmm|gmm|gmm|gmm|gmm|gmm|gmm|gmm|gmm|
gmm|gmm|gmm|gmm|gmm|gmm|gmm|gmm|gmr|   |   |   |   |   |   |   |   |   |   |   |   |gbl|gbm|ctl|gbm|gbm|gbm|gbm|gbm|ctr|gmm|ctl|gbm|gbm|gbm|gbm|ctr|gmm|gmm|gmm|gmm|gmm|gmm|gmm|
gmm|gmm|gmm|gmm|gmm|gmm|gmm|gmm|gmr|   |one|   |   |   |   |   |   |   |   |   |   |   |   |vmm|   |   |   |   |   |gml|ctl|gbr|   |   |   |   |gml|gmm|gmm|gmm|gmm|gmm|gmm|gmm|
gmm|gmm|gmm|gmm|gmm|gmm|gmm|gmm|gmr|   |   |   |   |hll|hmm|hrr|   |   |   |   |   |   |   |vmm|   |   |   |   |   |gml|gmr|   |   |   |   |   |gml|gmm|gmm|gmm|gmm|gmm|gmm|gmm|
gmm|gmm|gmm|gmm|gmm|gmm|gmm|gmm|gmr|   |   |   |   |   |   |   |   |   |   |   |   |one|   |vmm|   |one|   |one|   |gml|gmr|   |   |   |   |   |gml|gmm|gmm|gmm|gmm|gmm|gmm|gmm|
gmm|gmm|gmm|gmm|gmm|gmm|gmm|gmm|gmr|   |   |one|   |   |   |   |   |   |one|   |   |   |   |vmm|   |   |   |   |   |gml|gbr|   |   |gtl|gtm|gtm|cbr|gmm|gmm|gmm|gmm|gmm|gmm|gmm|
gmm|gmm|gmm|gmm|gmm|gmm|gmm|gmm|gmr|   |   |   |   |   |   |   |   |   |   |   |   |   |   |vbb|   |   |   |   |   |vbb|   |   |gtl|cbr|gmm|gmm|gmm|gmm|gmm|gmm|gmm|gmm|gmm|gmm|
gmm|gmm|gmm|gmm|gmm|gmm|gmm|gmm|gmr|   |   |   |   |   |gtl|gtr|   |   |   |   |vtt|   |   |   |   |   |vtt|   |   |   |   |   |gml|gmm|gmm|gmm|gmm|gmm|gmm|gmm|gmm|gmm|gmm|gmm|
gmm|gmm|gmm|gmm|gmm|gmm|gmm|gmm|cbl|gtm|gtm|gtm|gtm|gtm|cbr|cbl|gtr|   |   |   |vmm|   |   |   |   |   |vmm|   |   |   |   |gtl|cbr|gmm|gmm|gmm|gmm|gmm|gmm|gmm|gmm|gmm|gmm|gmm|
gmm|gmm|gmm|gmm|gmm|gmm|gmm|gmm|gmm|gmm|gmm|gmm|gmm|gmm|gmm|gmm|cbl|gtr|   |   |vmm|   |   |   |   |gtl|gmr|   |   |   |   |gml|gmm|gmm|gmm|gmm|gmm|gmm|gmm|gmm|gmm|gmm|gmm|gmm|
gmm|gmm|gmm|gmm|gmm|gmm|gmm|gmm|gmm|gmm|gmm|gmm|gmm|gmm|gmm|gmm|gmm|cbl|gtm|gtm|vbu|gtm|gtm|gtm|gtm|cbr|cbl|gtm|gtm|gtm|gtm|cbr|gmm|gmm|gmm|gmm|gmm|gmm|gmm|gmm|gmm|gmm|gmm|gmm|
gmm|gmm|gmm|gmm|gmm|gmm|gmm|gmm|gmm|gmm|gmm|gmm|gmm|gmm|gmm|gmm|gmm|gmm|gmm|gmm|gmm|gmm|gmm|gmm|gmm|gmm|gmm|gmm|gmm|gmm|gmm|gmm|gmm|gmm|gmm|gmm|gmm|gmm|gmm|gmm|gmm|gmm|gmm|gmm|
gmm|gmm|gmm|gmm|gmm|gmm|gmm|gmm|gmm|gmm|gmm|gmm|gmm|gmm|gmm|gmm|gmm|gmm|gmm|gmm|gmm|gmm|gmm|gmm|gmm|gmm|gmm|gmm|gmm|gmm|gmm|gmm|gmm|gmm|gmm|gmm|gmm|gmm|gmm|gmm|gmm|gmm|gmm|gmm|
gmm|gmm|gmm|gmm|gmm|gmm|gmm|gmm|gmm|gmm|gmm|gmm|gmm|gmm|gmm|gmm|gmm|gmm|gmm|gmm|gmm|gmm|gmm|gmm|gmm|gmm|gmm|gmm|gmm|gmm|gmm|gmm|gmm|gmm|gmm|gmm|gmm|gmm|gmm|gmm|gmm|gmm|gmm|gmm|
gmm|gmm|gmm|gmm|gmm|gmm|gmm|gmm|gmm|gmm|gmm|gmm|gmm|gmm|gmm|gmm|gmm|gmm|gmm|gmm|gmm|gmm|gmm|gmm|gmm|gmm|gmm|gmm|gmm|gmm|gmm|gmm|gmm|gmm|gmm|gmm|gmm|gmm|gmm|gmm|gmm|gmm|gmm|gmm|
gmm|gmm|gmm|gmm|gmm|gmm|gmm|gmm|gmm|gmm|gmm|gmm|gmm|gmm|gmm|gmm|gmm|gmm|gmm|gmm|gmm|gmm|gmm|gmm|gmm|gmm|gmm|gmm|gmm|gmm|gmm|gmm|gmm|gmm|gmm|gmm|gmm|gmm|gmm|gmm|gmm|gmm|gmm|gmm|
gmm|gmm|gmm|gmm|gmm|gmm|gmm|gmm|gmm|gmm|gmm|gmm|gmm|gmm|gmm|gmm|gmm|gmm|gmm|gmm|gmm|gmm|gmm|gmm|gmm|gmm|gmm|gmm|gmm|gmm|gmm|gmm|gmm|gmm|gmm|gmm|gmm|gmm|gmm|gmm|gmm|gmm|gmm|gmm|
END